##################
#                #
#B# ############ #
###              #
############ ### #
#                #
####### ######## # 
#                #
################A#